廿四妹	【晒无聊】
嘟嘟(*^__^*)	【晒】
逗比，你好	【晒-这是怀孕了吗？？】--已经到医院了。
蘑菇不开花　°	【晒嘴唇】不知道这样的算好看咩，请轻喷，第一次...
Sheldon	【晒昨天】2.23，雷神小动，虽不零，吾将留妹留者
小夏爱学习	【晒腿】坐等一千！
艾美丽	【晒】、-----------自己
时光隧道	【晒六级成绩】
我是熊仔呀	【晒勇气】惨不忍睹放一会就删
MR-CAMI	【晒成长】豆干变肉团~~
我想不出名字了	【晒个腿】上次晒胸 这次晒个腿吧
灭绝师太	【晒直卷发对比】  感觉头发快被玩坏了！！！
三三	【晒个毕业照吧】没胸没腿没看头。。。。更新一张...
ali	【晒无耻】
珑择裸啦	【晒高潮部分】女生脸色都变了
温尽欢 #	【更新！新床单！！晒腿 单纯的只是求关注！！】
张敏	猫扑女孩与男友XO图文直播！！！！！！！
Akira	【晒形象】都说我是屌丝，谁说不能逆袭了？
就是不想你知道	【晒胸】对是小胸怎么了。
大大大大舌头	【晒上身】 183 有点帅的男生 第一次晒
